111111111111111111111111111111
1000000000000011000000000000C1
100111001111001100111100111001
100111001111001100111100111001
1000000C0000000000000000000001
100000000000000000000000000001
100111001100111110011000111001
100000001100001000011000000001
100000001110001000111000000001
101110001110000000111000011101
10100000110000000001100000C101
101C0000110000P000011000000101
101110000000000000000000011101
100000000000000000000000000001
100000001000111110001000000001
100000001000001000001000000001
100000001000001000001000000001
100000000000000000000000000001
10111100111000E000111000111101
1000010000000000000000C0100001
100001000001111111000000100001
100001000000001000000000100001
10C000001000C01000001000000001
100000001000001000001000000001
100000001000000000001000000001
100001111111000001111111000001
100000000000000000000000000001
100000000000000000000000000001
10000000000000C000000000000X01
111111111111111111111111111111