1111111111111111111111111111111111111111111
1000011111000011111100000000000000000000011
1000111111100001111110000000000000000000001
1000000000000000011111100000000000000000001
100000000P000P00000000000C00000000000000001
1000000000000000111100000000000000X00000001
1000000011111000001000001000000000000000001
100000000E000000011100000000000000000000001
1111111111111111111111111111111111111111111