11111111111111111111111111111111111111111111111111111111111111111111111111111111
10000111110000111111000000000000000000000000000000000000000000000000000000000011
10001111111000011111100000000000000000000000000000000000000000000000000000000001
100P000000C000000111111000000000000000000000000000000000000000000000000000000001
100000000000000000C0000000000000000000000000000000000000000000000000000000000001
10000000000000001111000000000000000000000000000000000000000000000000000000000001
10000000111110000010000010000000000000000000000000000000000000000000000000000001
100000000E0000000111000000000000000000000000000000000000000000000000000000000001
10000000000000000000000000000000000000000000000000000000000000000000000000000001
10000000000000000000000000000000000000000000000000000000000000000000000000000001
10000000000000000000000000000000000000000000000000000000000000000000000000000001
10000000000000000000000000000000000000000000000000000000000000000000000000000001
10000000000000000000000000000000000000000000000000000000000000X00000000000000001
10000000000000000000000000000000000000000000000000000000000000000000000000000001
11111111111111111111111111111111111111111111111111111111111111111111111111111111