11111111
1PC0E001
1000X001
11111111