1111111111111111111111111111111111
10010000000C0100000000000000000001
1000011111001000000000000000000001
1000011111001000000000000000000001
1P0011E0000010C0000000000000000001
1111111111111111111111111111111111